NO ./texture/cw.xpm
SO ./texture/bricksx64.xpm
WE ./texture/grey.xpm
EA ./texture/re2.xpm

C 51,51,250
F 255,215,0

        1111111111111111111111111
        1000000000000000000000001
        1011000000000000001000001
        1001000000100000000100001
111111111011010000000000001000001
100011000011001001000111111111111
11110111111111011110000000001
11110111111111011101010010001
11000000110101011100000010001
10000000000000001100000010001
100000000000000N1101010010001
1100000111010101111101111010111
11110111 1110101 101111010001
11111111 1111111 111111111111
